8,0,8,kikiki37 (441),[問卦] 日本職業運動員很容易娶到美女藝人嗎?,Sat Nov 21 11:44:02 2020
2,0,2,devidevi (凱特),Re,Sat Nov 21 10:51:07 2020
5,7,-2,posen2012 (posen),Re,Sat Nov 21 06:00:28 2020
40,16,24,rocephin (Roce),[問卦] 皇家傳承牛工廠被稽查竟閉門 民眾疑有鬼,Sat Nov 21 10:12:40 2020
3,0,3,surimodo (搖滾少女!! 活力棉花糖!!),[問卦] 田園工廠可以地下工廠不行？,Sat Nov 21 11:56:16 2020
15,0,15,batt0909 (小魚),[新聞] 共和黨要亞利桑那州停止確認拜登勝選 法,Sat Nov 21 07:54:18 2020
5,4,1,hellohiro (☁☁☁☂),[問卦] 掃地阿婆走進男廁看到一堆鳥時在想啥？,Sat Nov 21 09:34:15 2020
6,1,5,Qorqios (☁☁銀長直傲嬌JK),[問卦] 水餃裡面油到跟湯包一樣？,Sat Nov 21 01:26:31 2020
5,3,2,radiotofu (電台豆腐),[問卦] 真的有小朋友去賣場哭一個小時的嗎？,Sat Nov 21 11:02:03 2020
1,0,1,Government (政府),[問卦] 你們當中沒犯過錯的可以拿石頭丟政府,Sat Nov 21 11:21:43 2020
5,5,0,tth9955 (EvilHeart),[問卦] 女高中生：「嗚哇！爽死了！爽死了！」,Sat Nov 21 02:33:15 2020
14,4,10,sammoon (sam),[問卦] 1122後島嶼就會天光了吧,Sat Nov 21 04:22:15 2020
13,6,7,semih (Sayginer),[新聞] 《桃園7連霸議員》 張運炳賄選 判3年半定,Sat Nov 21 07:41:25 2020
1,0,1,johanLarson (Rent),Re,Sat Nov 21 11:34:12 2020
30,3,27,zyc5566 (和風蒜頭雞湯),[問卦] 我很討厭現在的自己。,Sat Nov 21 05:12:42 2020
4,0,4,rote (ROTE),[問卦] 全台食品工廠都檢舉來抓地下的卦?!,Sat Nov 21 11:41:21 2020
0,0,0,johanLarson (Rent),Re,Sat Nov 21 11:48:48 2020
38,5,33,luke123 (teddy),Re,Sat Nov 21 02:11:15 2020
9,1,8,onepunchgg (onepunchgg),[問卦] Dell XPS15可以帶進星巴克嗎？,Sat Nov 21 11:55:50 2020
7,0,7,bear26 (熊二六),Re,Sat Nov 21 03:32:36 2020
2,0,2,psw (ICK),Re,Sat Nov 21 10:24:38 2020
2,2,0,autokey (該起床啦),[問卦] 坐815航班有什麼必做必點的八?卦,Sat Nov 21 09:25:55 2020
34,41,-7,jackymars5 ((                )),[問卦] 蕾拉長這樣也想紅?,Sat Nov 21 07:49:30 2020
8,1,7,qqq60710 (BUSTER),[問卦] 日本第一男公關 羅蘭算宅宅嗎？,Sat Nov 21 01:49:43 2020
2,0,2,cattielin (),Re,Sat Nov 21 11:03:53 2020
1,1,0,color3258 (請別盜我帳號 我很難過! ),[新聞]納豆每天摸金色瑪利歐盼擒金馬,Sat Nov 21 11:27:16 2020
4,49,-45,AnnaOuO (Anna),[問卦] 肯定沒人亂噓吧？,Sat Nov 21 05:50:07 2020
7,0,7,fangachien (沒前後ohlins 別洗車),[問卦] 有什麼事比抓黑道還嚴重,Sat Nov 21 01:19:52 2020
8,42,-34,WorkinChina (WIC),[新聞] 陳菊：蘇貞昌承擔責任辛苦 盼社會支持,Sat Nov 21 11:43:17 2020
3,2,1,elite9q (),[問卦] 現在手上有哪個比較土豪,Sat Nov 21 00:50:04 2020
35,6,29,Sron (讀書好嗎),[問卦] 台灣人那麼努力為什麼贏不了美國？,Sat Nov 21 02:35:07 2020
5,2,3,candon (candon),[問卦] 大家看的最後一部卡通是甚麼??,Sat Nov 21 11:48:04 2020
4,0,4,ru031121 (),Re,Sat Nov 21 03:35:13 2020
1,0,1,chihlong5566 (志龍五六),Re,Sat Nov 21 11:03:35 2020
6,0,6,dearbarry (莫言悲),[問卦] 三文小說跟三文魚有關係嗎?,Sat Nov 21 00:50:17 2020
4,8,-4,afire53 (afireyo),[新聞] 甜美女高中生上學突遭背後熊抱,Sat Nov 21 11:57:36 2020
5,2,3,tryit015124 (維尼彈著蕭邦的夜曲),[問卦] 共濟會討厭川普吧？,Sat Nov 21 03:07:55 2020
5,0,5,whiteadam (blue eyes blue),[問卦] 大阪西成區的八卦?,Sat Nov 21 01:32:37 2020
10,1,9,ntupeap (打發上課時間不能沒有我),[問卦] 有沒有鬼滅要硬留風柱的八卦,Sat Nov 21 03:47:01 2020
6,1,5,kuso2005 (一時想不到),[新聞] 破除換閣揆謠言？蔡英文蘇貞昌互相tag護,Sat Nov 21 00:47:52 2020
1,2,-1,tasogare (tasogare),[問卦] 拿地下工廠調理包牛肉麵去無限列車上賣?,Sat Nov 21 11:18:22 2020
3,4,-1,Hsins (迅雷不及掩耳盜鈴),[問卦] 靜靜悄悄默默淡淡的止住呼吸？,Sat Nov 21 01:07:24 2020
7,0,7,kobe7785075 (希志我的最愛),[問卦] 一個便當吃不飽為啥不吃兩個是對的！,Sat Nov 21 11:34:40 2020
5,2,3,gk1329 (),[問卦] 待轉大富翁幹嘛管,Sat Nov 21 10:35:42 2020
12,1,11,johanLarson (Rent),[問卦] 4%仔會不會太容易被帶風向,Sat Nov 21 11:23:28 2020
6,0,6,av012345610 (傘下智久),[問卦] 莫札特去過土耳其嗎？,Sat Nov 21 09:20:49 2020
0,0,0,FanFan123 (梵梵),[問卦] 台灣豬肉攤,Sat Nov 21 11:15:17 2020
9,5,4,a111111 ( ),[問卦] 日本人為何這麼壓抑？,Sat Nov 21 09:06:49 2020
11,0,11,t51113030 (=v=),[問卦] 有沒有中天新聞解套的方法？,Sat Nov 21 09:27:38 2020
4,1,3,flower42 (栗悟飯與龜波功),[問卦] 預算250元 火鍋vs拉麵 都幾?,Sat Nov 21 11:15:07 2020
10,2,8,shawnguo (尚恩),[爆卦] 三和路四段加油站一堆消防車出現,Sat Nov 21 02:18:01 2020
19,13,6,bf000777966 (joe),[新聞] 女友逼他買2支愛瘋「不買就分手」理由讓,Sat Nov 21 08:11:18 2020
11,1,10,z0953781935 (妹妹罵我是肥豬>///<),[問卦]有沒有唸電機走資工路線是唯一解的八卦,Sat Nov 21 07:10:10 2020
27,5,22,words2012 (づ′・ω・),"[問卦] 在夜店喝醉的女孩,難道不怕被撿屍?",Sat Nov 21 07:30:33 2020
6,2,4,westdoorcard (West),[問卦] 皇家傳承 若沒做虧心事 何必怕稽查,Sat Nov 21 11:54:20 2020
3,0,3,DoAsInfinity (D A I),[問卦] 沒有能力理解脈絡的人是不是很多,Sat Nov 21 09:53:49 2020
7,1,6,victoy0909 (維克玩具洞勾洞勾),[問卦] 五天沒清槍了怎辦？,Sat Nov 21 08:11:15 2020
49,34,15,ubcs (覺★青年超冒險蓋),[公告] 十一月份置底閒聊區,Mon Nov  2 23:07:38 2020
26,1,25,purue (purue),[問卦] 去丹丹必點什麼,Sat Nov 21 07:38:18 2020
12,1,11,dentalboy (hi),[問卦] 甲甲打砲為何要打藥,Sat Nov 21 11:54:29 2020
3,0,3,iamgaylan (),[問卦] 被兩隻狸貓騙到無人島上 怎辦,Sat Nov 21 11:06:10 2020
17,0,17,crash121 (衝撞小子),[問卦] 看了會很平靜舒服的影片？,Sat Nov 21 01:03:40 2020
7,0,7,tose4433 (Remax),[問卦] 金庸神鵰俠侶的小龍女是不是其實蠻騷的？,Sat Nov 21 03:02:19 2020
6,4,2,yoyodiy (廢文心得文大師),[問卦] 炸醬麵這樣大概可以幾分?,Sat Nov 21 11:22:36 2020
3,0,3,silvertime (silvertime),[問卦] 幫養狗養到死掉賠多少錢合適,Sat Nov 21 10:24:21 2020
6,0,6,LaAc (深淵戰士),[問卦] 一直在懷念古早榮光的大學在想什麼,Sat Nov 21 01:12:39 2020
3,0,3,pauljet (我好慚愧我居然當過川黑),[問卦] 有沒有MMR的八卦？,Sat Nov 21 10:52:31 2020
232,25,207,obov5116 (慶記市第一金城武尊),[問卦] 動漫史上最精彩單挑是哪一組的八卦？,Sat Nov 21 05:21:58 2020
16,0,16,s930406 (你啊罵),[問卦] 自律神經失調該怎麼辦,Sat Nov 21 03:58:54 2020
2,2,0,del680202 (HANA),[問卦] ubereat為何這麼    ,Sat Nov 21 09:41:51 2020
8,0,8,YenFuOne (焉芙丸),"[問卦] 未來哪個科技,會先泡沫化???",Sat Nov 21 09:33:07 2020
3,0,3,redDest (紅紅),[問卦] 知名餐廳是什麼時候也開始出調理包的?,Sat Nov 21 10:58:29 2020
2,1,1,jej (賊一賊),[問卦] 公車 禮讓行人 與行車右轉,Sat Nov 21 11:12:06 2020
53,3,50,rocephin (Roce),[問卦] 皇家傳承  還有什麼可以查的嗎？,Sat Nov 21 10:51:03 2020
1,0,1,Birthday5566 (生日5566),Re,Sat Nov 21 11:47:00 2020
1,1,0,k1400 (德州家康),Re,Sat Nov 21 10:21:12 2020
18,3,15,a78914124 (U文製造機),Re,Sat Nov 21 00:54:08 2020
1,0,1,chengcti (版主請投我一票!),Re,Sat Nov 21 10:45:39 2020
5,0,5,oz5566 (威廉。霍恩索倫),Re,Sat Nov 21 10:40:45 2020
3,3,0,skizard ( ),Re,Sat Nov 21 09:58:21 2020
13,5,8,hoyumi (正版型男...無誤!!!),[新聞] 蟬聯米其林的刈包！　老闆賣30年：我沒,Sat Nov 21 02:39:45 2020
1,0,1,Qorqios (☁☁銀長直傲嬌JK),Re,Sat Nov 21 00:46:56 2020
28,2,26,mark751019 (☆比哈士奇帥一點☆),[新聞] 被控診間與女病患發生關係 精神科男醫自,Sat Nov 21 09:15:11 2020
15,1,14,WuDunE (GLAUCUS),[問卦] 和尚看到漂亮女施主會硬嗎,Sat Nov 21 08:16:08 2020
4,2,2,lockgolden (鎖金),[問卦] 武肺病毒是中國針對白種人的生物武器?,Sat Nov 21 11:33:58 2020
1,1,0,yahooyamgoog (安安唷),[問卦] 還有人被套牢比特幣嗎,Sat Nov 21 10:28:43 2020
1,0,1,q9154336 (SSB),[問卦] 可人的雷包女孩兒？？？,Sat Nov 21 07:59:57 2020
26,16,10,pujipuji (),[新聞] 首屆經濟對話　台美簽署MOU,Sat Nov 21 09:59:14 2020
0,1,-1,MiLuDaiBoom (ⓂⓛⓁⓤⒹⓐⓛⒷⓞⓞⓂ),[問卦] 印度豹繁殖力如何？,Sat Nov 21 10:05:11 2020
2,4,-2,obayliskdgsb (巨神兵),[問卦] 新竹綠線司機的問題是不是最多？,Sat Nov 21 08:59:57 2020
12,4,8,bcyeh (傑輪特),[問卦] 台灣人怎麼能忍受機車的吵雜聲？,Sat Nov 21 10:51:05 2020
6,0,6,funsky (小妹笑嘻嘻OuO),[問卦] 在外面看gura會很臭嗎,Sat Nov 21 11:13:42 2020
9,3,6,inoce (),[問卦] 今年若有10大惡人代表入圍的有？,Sat Nov 21 09:06:13 2020
9,18,-9,Katsuyuki118 (勝之),[新聞] 新冠疫苗買到了 陳時中曝「口袋已有一些,Sat Nov 21 11:30:26 2020
23,1,22,VortexSheet (哦?),[問卦] 暴雪是不行了嗎?,Sat Nov 21 05:08:11 2020
30,3,27,Tencc (10cc),[問卦] 有沒有99%女孩卸妝都是普通人的八卦?,Sat Nov 21 08:34:55 2020
3,0,3,alivereason (活理由),[問卦] 反正我很閒解散的話會關注誰的頻道？,Sat Nov 21 11:29:35 2020
21,8,13,b1b2b3b4 (lemon),[問卦] 張忠謀為什麼不回美國養老?,Sat Nov 21 03:25:40 2020
5,2,3,hwang1460 (面癱P),Re,Sat Nov 21 08:52:14 2020
1,0,1,ccyaztfe (best_troll_tw),[問卦] queen的兩首體育神曲會被超越嗎？,Sat Nov 21 10:25:03 2020
15,4,11,belucky (),[問卦] 為啥一堆人幫拒檢的工廠抱不平阿,Sat Nov 21 08:54:44 2020
41,3,38,alexhsu0909 (),[問卦] 發現自己是廢物怎麼辦？,Sat Nov 21 02:41:37 2020
2,5,-3,FlashWolves (大谷桑a粉絲),[問卦] 遇到阿富汗牧羊人該殺還是放走？,Sat Nov 21 06:13:52 2020
3,4,-1,seabox (盒盒),[公告] 八卦板板規(2020.10.11),Sun Oct 11 00:00:02 2020
0,2,-2,bamama56 (bamama),[問卦] Young Guns Everybody loves you ,Sat Nov 21 07:38:08 2020
6,2,4,a210510 (嗚嗚~),[問卦] 為什麼新竹光復路違停那麼嚴重？,Sat Nov 21 11:24:05 2020
7,0,7,taiwan2012 (台灣2012),[問卦] 有沒有桃園客運的八掛,Sat Nov 21 10:59:25 2020
5,0,5,qazsedcft (自由羊),[新聞] 解密》「黃色小鴨」成泰國反政府抗爭吉,Sat Nov 21 10:59:40 2020
8,0,8,NUMB43 (晚了~該睡了),[問卦] 桃乃木香奈怎麼減了又減,Sat Nov 21 09:12:05 2020
6,0,6,mean (低智商生活),Re,Sat Nov 21 01:31:19 2020
0,0,0,parttime (隱),[問卦] 臺灣是不是還在內鬥、內耗啊？,Sat Nov 21 11:59:36 2020
3,4,-1,MrFly (MrFly),[問卦] 在R18.com買了160鎂的A片算財富自由嗎,Sat Nov 21 11:33:16 2020
14,1,13,jp6vu04boy (客家肥肥),[問卦] 欸欸欸有阿伯在台鐵上運動,Sat Nov 21 08:52:25 2020
1,0,1,wwf1310 (大賺3千小賠5萬),[問卦] 好悶如何自處？,Sat Nov 21 00:44:35 2020
16,0,16,herbert0716 ((っ・ω・)っ),Re,Sat Nov 21 02:14:20 2020
19,2,17,cleversun (bubu大),Re,Sat Nov 21 09:15:59 2020
12,8,4,onetiger (一虎),[新聞] 力挺王雪紅！老爸買宏達電當存股4年：一,Sat Nov 21 01:26:02 2020
2,0,2,Wardyal (Super捏捏雞),[問卦] 第一個說哭阿的是誰?,Sat Nov 21 07:10:13 2020
202,39,163,mars1985 (╰|∵|╯),[新聞] 北市信義區女學生遭熊抱拖進夾娃娃店 噁,Sat Nov 21 09:18:56 2020
43,4,39,bamama56 (bamama),[新聞] 長榮空姐挺罷工嗆「加料」 2男酸她母豬,Sat Nov 21 11:52:30 2020
3,3,0,GhostFather (鬼父Oni Chichi),[問卦] 我朋友被女同學監禁 診摸辦？,Sat Nov 21 02:28:31 2020
1,1,0,RedChoi ( ),[問卦] 台北當了幾十年首都是怎麼掉到第四大城,Sat Nov 21 11:23:44 2020
0,1,-1,zntozteent (百香綠加椰果),[問卦] 釋然？,Sat Nov 21 03:33:40 2020
4,0,4,joe255118 (酷比),[問卦] 工廠被稽查幹嘛一定要開門?,Sat Nov 21 10:27:54 2020
0,3,-3,foreverthink (曹雞拜振恰倪嵐),[問卦] 現在牛肉有標萊克多巴胺嗎？,Sat Nov 21 01:00:59 2020
5,0,5,PrinceKanto (岩本蓮加は俺の娘),[新聞] 007婚姻危機？丹尼爾克雷格歹逗陣 老婆,Sat Nov 21 08:54:36 2020
1,1,0,as6633208 (okokokiknow),Re,Sat Nov 21 09:48:55 2020
10,3,7,w510048 (黨的恩情比山高),[問卦] 中國到底是真的很有錢還是假的??,Sat Nov 21 02:00:46 2020
10,1,9,Lorazin (Lorazin),Re,Sat Nov 21 11:19:31 2020
5,2,3,rdplyr (cook),[問卦] 要怎麼追母胎單身棉花糖女孩,Sat Nov 21 04:04:34 2020
9,0,9,Francise (少喝飲料多喝水),[問卦] 台灣妹叫什麼？,Sat Nov 21 00:46:15 2020
11,9,2,czzhf (czzhf),[問卦] 哪種國考值得考？,Sat Nov 21 09:38:44 2020
8,2,6,Scathach (紫色BBA),[問卦] 有沒有中正大學又出事的八卦？,Sat Nov 21 10:55:19 2020
6,0,6,ryusenming ( ),[問卦] 0050賺錢可以聞女同事的腳趾縫嗎？,Sat Nov 21 10:08:49 2020
3,1,2,jp6vu04boy (客家肥肥),[問卦] 欸欸，不影響人的抗議能幹嘛,Sat Nov 21 08:35:04 2020
20,3,17,ShenVen5566 (三代自耕農),[問卦] 現在年輕人認為黃明志比周杰倫屌？,Sat Nov 21 11:41:29 2020
65,2,63,JellyKing (Lee DoRa),Re,Sat Nov 21 02:37:01 2020
9,5,4,words2012 (づ′・ω・),Re,Sat Nov 21 07:02:51 2020
5,0,5,Luwan (貝特曼),[問卦] 有沒有TPA經理Erica後來去哪的八卦？,Sat Nov 21 02:16:35 2020
238,2,236,jericho07 (),[協尋] 11/2新竹光復高中路口影,Fri Nov 13 11:12:59 2020
2,0,2,Kimmy (Kimi),[問卦] 版上股災很多人嘲笑巴菲特創新高就閉嘴了,Sat Nov 21 10:56:53 2020
13,5,8,yang0623 (commencement),Re,Sat Nov 21 10:09:40 2020
1,8,-7,iamgaylan (),[問卦] 八卦因該禁止c罩杯以下的人噓文,Sat Nov 21 09:50:28 2020
8,2,6,rote (ROTE),Re,Sat Nov 21 10:47:56 2020
0,1,-1,hydroer (水人),[問卦] 叫做富O義O的人是不是都很強的八卦？,Sat Nov 21 11:53:52 2020
2,1,1,Morrislakbay (莫里斯四方報),Re,Sat Nov 21 11:26:37 2020
5,10,-5,kenny1300175 (蘇湖),[新聞] 中天下架》馬英九:不是一個民主國家該做的事,Sat Nov 21 09:52:54 2020
4,1,3,Ujdhw3425 (ccc),[問卦] 現在是當兵爽還是替代役爽？,Sat Nov 21 11:34:17 2020
3,0,3,s2678132 (重力可可),Re,Sat Nov 21 07:07:00 2020
139,74,65,DuDu (林北告到你無處躲),[新聞] 「待轉大富翁」又來了！北市百警出動 下,Sat Nov 21 08:55:57 2020
27,6,21,bbob (小海),[問卦] 一提到機車亂象大家會想到什麼東西呢？,Sat Nov 21 08:24:43 2020
7,0,7,dioradio (HIRO),[問卦] 亂馬二分之一的主角可以自己解決性需求,Sat Nov 21 01:34:01 2020
3,3,0,jinnsei (人生),[問卦] 當年看過刀語 薄刀戰 有多震撼,Sat Nov 21 09:29:04 2020
18,6,12,Rambo (香帥),[爆卦] 美國單日新增超過20萬例 新冠肺炎確診,Sat Nov 21 09:08:51 2020
6,3,3,fatslave (),[問卦] ipod之後怎麼都不出了,Sat Nov 21 07:51:28 2020
2,1,1,shampoopoo (毛寶洗髮精),Re,Sat Nov 21 06:50:30 2020
5,15,-10,xzcb2008 (天下霸道之情色喵),[問卦] =.= 拜託你們手機殼黃了就換一個好嗎？,Sat Nov 21 09:17:51 2020
1,4,-3,jaids (做工的人),Re,Sat Nov 21 04:51:41 2020
4,0,4,rfvujm (Rfvujm),Re,Sat Nov 21 09:19:42 2020
59,7,52,Audrey23 (奧德麗),[新聞] 調理包工廠拒檢？皇家傳承：會配合檢查,Sat Nov 21 10:35:03 2020
8,1,7,became (windim),[問卦] 為什麼好好的遊行，搞得像雜碎麵一樣呢,Sat Nov 21 11:27:17 2020
7,0,7,Beanoodle (津崎似超人平匡先生),Re,Sat Nov 21 07:15:39 2020
4,0,4,meblessme (地球太可怕我要回火星),[問卦] 全世界都沒有秘密真的不好嗎？,Sat Nov 21 08:38:45 2020
2,0,2,CuLiZn5566 (同理心5566),Re,Sat Nov 21 08:17:16 2020
1,0,1,mean (低智商生活),Re,Sat Nov 21 01:16:44 2020
8,0,8,ohx64 (),[問卦] 海底有大型動物 天空怎麼沒有大型動物阿?,Sat Nov 21 09:53:44 2020
3,0,3,gn01982027 (夢露是個好樂團),[問卦] 日本人為何喜歡大莖洨怪???,Sat Nov 21 11:22:12 2020
6,1,5,karta328 (我不知),[問卦] 臉書審查系統是不是真的沒有用,Sat Nov 21 02:14:38 2020
2,1,1,akanishiking (arnold jackson),[問卦] 洗腦別人很容易嗎？,Sat Nov 21 07:58:27 2020
3,0,3,became (windim),Re,Sat Nov 21 11:39:28 2020
2,1,1,popy8789 (面對它),[問卦] 台男被台女騙 但台女要洋男才能騙？,Sat Nov 21 08:00:05 2020
0,0,0,dickhole5566 (馬眼),Re,Sat Nov 21 12:05:04 2020
7,1,6,BrandonRoy7 (優文製造機),[問卦] 用六年的iphone的電池健康度應該多少,Sat Nov 21 09:08:44 2020
0,0,0,moghtw11111 (如果我是迪杰),[問卦] 當兵要注意什麼？！,Sat Nov 21 12:04:20 2020
4,1,3,Qorqios (☁☁銀長直傲嬌JK),Re,Sat Nov 21 01:40:03 2020
4,0,4,Lorazin (Lorazin),Re,Sat Nov 21 10:42:15 2020
1,0,1,LeonardoChen (LeonardoChen),Re,Sat Nov 21 03:24:10 2020
15,3,12,kashima228 (承),[問卦] 台灣交通亂象有何解方？,Sat Nov 21 11:02:06 2020
1,18,-17,frzqp3814396 (咩咩咩咩咩),[問卦] 洞拐洞洞！操場集合完畢！,Sat Nov 21 06:37:08 2020
13,15,-2,JeremyYi (啾咪易),[問卦] 花幾萬買錶的是不是盤子？,Sat Nov 21 07:20:05 2020
11,1,10,ltytw (拉米亞妹妹),[問卦] 版上有機師嗎,Sat Nov 21 03:13:09 2020
24,0,24,mokfadsa (mokfadsa),[問卦] 望高寮的夜景,Sat Nov 21 01:21:29 2020
12,3,9,DamnKobe (KoberInNTHU),[問卦] 被硬上了怎麼辦 在線等,Sat Nov 21 01:54:50 2020
1,2,-1,filmystery (P.B. take me to the US),[問卦] 大家聽過沙摩柯奮刺死甘寧良將的故事嗎??,Sat Nov 21 11:05:21 2020
15,4,11,gracew0709 (suprasegmental),[問卦] 台男小秘密☁,Sat Nov 21 02:22:48 2020
7,1,6,wang1b (唯i廢文<3),[問卦] 誰還記得是誰先說永遠的愛我？,Sat Nov 21 00:45:29 2020
7,1,6,tudo0430 (可愛いは正義であり！),[問卦] 慟！大腸麵線居然沒放香菜！,Sat Nov 21 07:12:39 2020
6,6,0,svd237 (ggsmida),[問卦] 帶狗進早餐店的人在想啥,Sat Nov 21 10:05:48 2020
4,0,4,foreverthink (曹雞拜振恰倪嵐),Re,Sat Nov 21 01:51:09 2020
50,0,50,yuzukineko (閃亮三叔公),[新聞] 裝滿「PS5主機」貨車被洗劫！零售商緊急,Sat Nov 21 11:07:08 2020
7,0,7,yoyoflag (伊莉一咻),[問卦] 有沒有哪部歐美軍事片 專門演霸凌的?,Sat Nov 21 01:08:55 2020
3,1,2,inoce (),[問卦] 方丈心眼484都特別小？,Sat Nov 21 08:51:40 2020
23,0,23,mike158 (麥可彼),[問卦] 有沒有高雄youbike2.0大成功的八卦,Sat Nov 21 11:30:12 2020
3,0,3,xeloss (蟹工船の労働者),Re,Sat Nov 21 00:49:10 2020
3,3,0,lpbrother (LP哥(LP = Love & Peace)),[問卦] 為什麼沒有行人發起斑馬線大富翁活動？,Sat Nov 21 07:13:59 2020
5,2,3,rasiel0919 (小弟弟),[問卦] 欸欸，開始健身的是不是都不喝酒啊,Sat Nov 21 08:14:24 2020
26,5,21,ptt987654321 (),[問卦] 如果國家機器針對，你各位有把握全身而退,Sat Nov 21 10:46:33 2020
1,0,1,chucky (衛藤x白石x橋本),Re,Sat Nov 21 10:56:39 2020
42,39,3,QmaxQ (行動代號185),[問卦] 為何警察對機車特別兇,Sat Nov 21 08:06:51 2020
5,2,3,edison321 (我偏要動幾動),[問卦] 統一鮮乳和味全鮮乳什麼時候消失了？,Sat Nov 21 01:52:04 2020
6,1,5,cruelgentle (Heidelberg),[問卦] 看到嘴巴張開的女生,Sat Nov 21 05:16:38 2020
3,0,3,vs3 (TOOLMAN),Re,Sat Nov 21 06:53:36 2020
5,0,5,kuma525566 (毛怪),[問卦] IOS選字到底有什麼毛病?,Sat Nov 21 11:27:07 2020
4,2,2,Lineage097 (狐狸壽司),Re,Sat Nov 21 08:04:27 2020
21,0,21,q5h67z (shinoda77),[問卦] 哪個youtuber會第一個幫美豬業配？,Sat Nov 21 01:20:36 2020
4,5,-1,sysop5566 (馬丁路德),[問卦] 什麼食物有催淫的效果?,Sat Nov 21 09:32:05 2020
5,25,-20,zzyyxx77 (討噓大師77),[新聞] 徐正文號召百台商連署「包機方案」　盼,Sat Nov 21 10:55:23 2020
6,2,4,moriyako (何妨吟嘯且徐行),[問卦] 停路邊付費停車格的人484很笨？,Sat Nov 21 11:50:28 2020
43,23,20,poeta (鍵盤詩人),[新聞] 台中連日空品不佳 卓冠廷感慨：是過去太,Sat Nov 21 10:19:04 2020
5,0,5,EricTCartman (阿ㄆㄧㄚˇ),[問卦] 請問這個動作應該取叫畫龍點睛還蜻蜓點水,Sat Nov 21 10:07:37 2020
6,1,5,autokey (該起床啦),[問卦] 去台中玩待轉大富翁要先準備什麼的八卦?,Sat Nov 21 09:57:04 2020
6,4,2,words2012 (づ′・ω・),"[問卦] 在海邊穿很少的女孩,難道不怕被色狼偷窺!",Sat Nov 21 07:17:34 2020
7,0,7,akumakei (敏敏特穆爾),"[問卦] 抓姦女割雞雞,那男割哪裡?",Sat Nov 21 08:01:41 2020
4,2,2,EBVirus (洨洨積極哥),[問卦] 台灣食安根本笑話，吃美豬剛好吧,Sat Nov 21 11:44:04 2020
26,4,22,taiwan08 (save the one for all),[新聞] 獨家 | 福義軒出包!結盟里仁熱銷胚芽餅 ,Sat Nov 21 08:54:57 2020
5,2,3,teeheehee (軟尾拋拋翔(′・ω・`)),[問卦] 拜登484比川普還更種族歧視==？,Sat Nov 21 10:49:01 2020
0,0,0,ayianayian (123),[問卦] 照規定辦理，農地工廠什麼時候拆？,Sat Nov 21 11:51:16 2020
3,2,1,ccyaztfe (best_troll_tw),[問卦] 坐在無限屍速列車上面該怎麼辦？,Sat Nov 21 09:25:51 2020
6,0,6,andrewkuo (),[問卦] Sanyo為啥在台灣看不到了?,Sat Nov 21 09:57:57 2020
1,3,-2,GodVoice (神音),Re,Sat Nov 21 10:53:50 2020
6,2,4,qw5980162 (台中家庭教師包莖哥),[問卦] 暗戀怎麼這麼難受??,Sat Nov 21 00:49:17 2020
3,1,2,kaitai (測試),[問卦] 玩糖豆人害人後會有罪惡感是什麼情況?,Sat Nov 21 11:25:45 2020
16,2,14,zo6al (我書讀得少 你不要騙我),Re,Sat Nov 21 01:42:13 2020
7,1,6,EricTCartman (阿ㄆㄧㄚˇ),[問卦] 2024總統大選應該看哪台開票？,Sat Nov 21 08:58:42 2020
11,10,1,rdplyr (cook),[問卦] 智商很高物理卻學不起來,Sat Nov 21 01:41:26 2020
2,0,2,KasmirLo (科科科~),[問卦] 乾燥的空氣有多舒服,Sat Nov 21 08:03:28 2020
6,3,3,aure0914 (tunik),[問卦] 為什麼胡瓜大家叫他瓜哥，而不是胡哥？,Sat Nov 21 09:53:36 2020
4,1,3,yoyoboy1 (就是這樣~),Re,Sat Nov 21 03:35:30 2020
2,0,2,tools (tools),[問卦] 有沒有影子官員的八卦,Sat Nov 21 11:05:48 2020
4,1,3,fnm525 (Nananiji love),[問卦] 片假名要怎麼背阿？,Sat Nov 21 11:22:20 2020
8,0,8,NTUisgood (台大真好),Re,Sat Nov 21 11:30:12 2020
5,15,-10,lllll12b56 (張航嘉),[問卦] 被譽為千年一遇美少女 愛莉莎莎羞喊：,Sat Nov 21 11:24:09 2020
52,12,40,lpbrother (LP哥(LP = Love & Peace)),[問卦] 有沒有越南文化都傳不進台灣的八卦？,Sat Nov 21 08:18:49 2020
1,0,1,yoyoflag (伊莉一咻),[問卦] 華農戲豬 在YT消失 但BILI有人轉去 WHY?,Sat Nov 21 01:27:28 2020
9,0,9,pooznn (我~~~是來被打臉滴!!!),[新聞] YY直播母公司股價暴跌26.5％ 渾水踢爆：,Sat Nov 21 01:43:20 2020
5,0,5,ethanwu0414 (伊森),[問卦] 預訂吃燒肉還要回覆確認？,Sat Nov 21 10:32:07 2020
2,5,-3,skizard ( ),[新聞] 比現有搭機遊程貴3倍!旅行社不敢賣 林佳,Sat Nov 21 01:11:06 2020
6,3,3,laptic (靜夜聖林彼岸花),[新聞] 道路限速時速50公里 他服用FM2飆速160公里撞死婦人,Sat Nov 21 11:32:50 2020
1,3,-2,HDSM (Love Not Change  O'_'O),[問卦] 我想我是真的愛妳 再痛也會真心地祝福妳,Sat Nov 21 01:18:30 2020
25,13,12,akway (生活就是要快樂),[新聞] 婦人入境攜豬肉捲遭罰20萬 「空姐給的」,Sat Nov 21 10:25:02 2020
6,1,5,johanLarson (Rent),Re,Sat Nov 21 10:00:22 2020
11,1,10,taiwannext (2016綠營重新執政 ),[問卦]中國不爭琉球 卻要爭釣魚台主權？,Sat Nov 21 11:19:54 2020
2,1,1,kmtkmtkmt (kmtkmtkmt),[問卦] 待轉仔為啥不去南部郊區舉辦待轉大富翁,Sat Nov 21 09:44:42 2020
9,7,2,alex1987 (基努李維),[新聞] 內閣改組頻傳 蘇揆臉書秀護國團隊半年成績,Sat Nov 21 01:32:02 2020
9,1,8,osalucard (墮落的月光),[問卦] 明天五毛要加班嗎？,Sat Nov 21 10:18:41 2020
9,0,9,Cocochia (我是閃電經濟學家),[問卦]  發起「關心附近牛肉麵店家」行動,Sat Nov 21 03:03:34 2020
3,0,3,CuLiZn5566 (同理心5566),Re,Sat Nov 21 09:49:50 2020
10,4,6,badjye911 (阿三),[問卦] 為什麼貨運司機做那麼久腰都不會痛？,Sat Nov 21 02:02:46 2020
2,0,2,z0953781935 (妹妹罵我是肥豬>///<),Re,Sat Nov 21 09:47:07 2020
5,0,5,royroy666 (老鼠),Re,Sat Nov 21 11:42:36 2020
22,3,19,Emerson158 (紅豆 X 八嘎 X 烏魯賽),"[問卦] 加木耳絲的拉麵,就真的很台嗎?",Sat Nov 21 01:40:16 2020
5,5,0,Superxixai (洪粉吱已),[問卦] 大麻被列為毒品，不是因為它很「毒」？,Sat Nov 21 10:33:06 2020
1,0,1,newsyho (newsyho),Re,Sat Nov 21 11:55:50 2020
9,0,9,Xensor (Xenx),[問卦] 烤肉垃圾亂丟兩個月就退燒了？,Sat Nov 21 10:39:07 2020
1,0,1,davidex (玉藻前我的),Re,Sat Nov 21 11:20:48 2020
1,1,0,TalkToMe (跟我說一下啦),Re,Sat Nov 21 07:31:33 2020
0,0,0,ECZEMA (ID 亂取的啦!),Re,Sat Nov 21 09:17:24 2020
2,2,0,twfi75 (小揚揚),[問卦] 現在新手機的拍照畫質如何？,Sat Nov 21 10:49:41 2020
18,0,18,aaaba (小強),[問卦] 要如何請「突擊稽查」的人三天後再來？,Sat Nov 21 10:36:32 2020
3,2,1,CuLiZn5566 (同理心5566),Re,Sat Nov 21 07:58:22 2020
34,4,30,sky9527 (歡迎來到Sky大舞廳),[問卦] 在通化夜市某蚵仔煎吃到鐵絲,Sat Nov 21 00:52:57 2020
9,1,8,Piracetam992 (索羅斯小熊),[問卦]你各位多久換一次空濾啊,Sat Nov 21 09:07:38 2020
3,0,3,lunanightcat (地球人觀察協會-代號微塵),[問卦] 先讓一部分人富起來是不是很騙？,Sat Nov 21 11:28:55 2020
2,0,2,illdoit (我會做到),[問卦] 空氣清淨機那台好,Sat Nov 21 11:52:44 2020
4,0,4,SSZZ77 (甲殼類過敏),[問卦] 下一個是什麼局來調查啊？,Sat Nov 21 11:07:29 2020
17,43,-26,realtw (realtw),[問卦] 三民自大紀元造謠可以 中天不行？,Sat Nov 21 08:20:54 2020
4,0,4,pchion2002 (阿我就怕被罵阿),[問卦] 狗官的八卦？,Sat Nov 21 08:15:18 2020
3,0,3,rexlin (Some like it hot!!),[問卦] 大家可以接受開車被下指導棋嗎?,Sat Nov 21 10:41:36 2020
8,4,4,ZMittermeyer (ZM),Re,Sat Nov 21 01:05:06 2020
3,7,-4,currry (南港李國毅),鮪魚也太油了吧,Sat Nov 21 08:56:40 2020
2,0,2,pwh811213 (PWH),[問卦] 有沒有草屯煙很大的八卦,Sat Nov 21 08:13:14 2020
11,5,6,Superxixai (洪粉吱已),[問卦] 皇家傳承牛肉麵正在被清算嗎？,Sat Nov 21 09:53:12 2020
12,2,10,kruscal (),[問卦] 蕭峰為什麼不接受康敏啊？,Sat Nov 21 10:21:41 2020
3,2,1,poeta (鍵盤詩人),Re,Sat Nov 21 10:40:00 2020
0,0,0,Timorepeto (Timerepeto),[問卦] 是否需要昇華影片主題？,Sat Nov 21 11:54:10 2020
6,2,4,Sixigma (六西格瑪),Re,Sat Nov 21 01:28:45 2020
2,2,0,jej (賊一賊),[問卦] 性交為什麼不定義成...,Sat Nov 21 07:12:42 2020
8,0,8,twnndnpdnc (資收王),Re,Sat Nov 21 02:55:43 2020
18,15,3,Punchline (哏),[問卦] 只有我打死不買AMD嗎？,Sat Nov 21 09:20:16 2020
0,0,0,yoyostar1990 (~Yoyo~),[問卦] 有沒有黑洞大師的八卦,Sat Nov 21 00:47:48 2020
3,3,0,words2012 (づ′・ω・),Re,Sat Nov 21 08:00:59 2020
11,1,10,TaraSoYeon (素妍魂),[問卦] 主人打砲時寵物都在旁邊幹嘛？,Sat Nov 21 01:37:36 2020
8,0,8,davidex (玉藻前我的),[問卦] 掃地僧怎麼認出小無相功的啊？,Sat Nov 21 06:30:16 2020
0,0,0,alex10282 (豆格),Re,Sat Nov 21 12:00:22 2020
10,1,9,bloodsweat (痛苦肥宅),Re,Sat Nov 21 09:36:48 2020
1,3,-2,a12345x (到不了終點),[問卦] 台gg是因為廣設大學而變強嗎,Sat Nov 21 01:26:16 2020
0,0,0,NASHISMAGIC (nashisgood),[問卦] 台北市最強的行政區？,Sat Nov 21 12:00:14 2020
2,0,2,whiteadam (blue eyes blue),[問卦] 李昌鈺,Sat Nov 21 01:06:43 2020
17,7,10,craig5566 (飛天少女豬),[問卦] 快被帥哥男同事掰彎了該怎麼辦？,Sat Nov 21 10:03:32 2020
9,1,8,shampoopoo (毛寶洗髮精),Re,Sat Nov 21 01:48:59 2020
6,1,5,kenzo (kenzo),[新聞] 高雄綠議員又批韓國瑜清水溝 鄭照新：請,Sat Nov 21 01:31:12 2020
7,0,7,sodistrues (true),Re,Sat Nov 21 11:32:35 2020
9,2,7,linda17a3 (),[新聞] 少女裸照被po全球最大色情網 驚!竟是男,Sat Nov 21 04:42:55 2020
0,0,0,rainylife (rainylife),[問卦] 當年拍巧連智的小孩現在在幹嘛？,Sat Nov 21 11:01:53 2020
149,70,79,purue (purue),[新聞] 「瘋」電滅漁！全台最大漁場北方三島遭,Sat Nov 21 08:43:52 2020
0,0,0,A816 (♥七瀬丸的灰太狼♥),Re,Sat Nov 21 09:48:57 2020
4,2,2,oftisa (oo),Re,Sat Nov 21 11:46:51 2020
7,7,0,island51 (Syuan),[問卦] 發現今天要結婚了怎麼辦？,Sat Nov 21 03:34:17 2020
9,14,-5,CHL98 (CHL),[新聞] 吃飯用「餐廳湯匙」餵狗！隔壁桌客人氣炸,Sat Nov 21 00:47:54 2020
9,8,1,linhu8883324 (SirLinhu),[新聞] 有線非公共財 學者酸政院搞錯,Sat Nov 21 08:04:38 2020
0,0,0,ivorysoap (ivorysoap),[問卦] 各位如果回到國高中時代也會喜歡鬼滅吧?,Sat Nov 21 11:26:15 2020
31,2,29,Workforme (′‧ω‧‵),[新聞] 獨家 | 吐司店員不滿被開單　竟推桌嗆警,Sat Nov 21 07:20:00 2020
16,2,14,shangguan125 (反串仔),[問卦] 為何八卦才半天而已牛肉麵文被洗這麼兇?,Sat Nov 21 11:40:37 2020
4,0,4,footart (reminiscence),[問卦] 30歲以後要維持體脂在15%很難嗎,Sat Nov 21 11:41:08 2020
188,5,183,radiohead56 (L o S e r f a t n e r D),[問卦] Panasonic為何在台灣很紅？,Sat Nov 21 06:56:25 2020
0,0,0,uuuvvv333 (kancero ),[問卦] 如果大學還沒畢業先修滿碩士學分,Sat Nov 21 12:02:57 2020
0,0,0,mean (低智商生活),Re,Sat Nov 21 01:07:20 2020
11,3,8,ZengMaktub (YOYOMAK),[問卦] 為什麼有女孩兒喜歡自稱肥宅？,Sat Nov 21 10:09:18 2020
12,1,11,ThomasBuBu (噗噗),[新聞] 比悲傷更悲傷！送葬隊伍遭貨車逆向衝撞..,Sat Nov 21 01:24:37 2020
15,6,9,Whitening (whitening),[問卦] 違法工廠只要不用萊牛你就敢吃??,Sat Nov 21 08:13:28 2020
3,3,0,alonenfree (finalJR),[問卦] 手機殼殼什麼時候才會被發明出來？,Sat Nov 21 02:49:17 2020
73,44,29,hyoerious (沒實力不要大小聲),[問卦]牛肉麵用地下工廠調理包拿冠軍 是不是很屌,Sat Nov 21 10:54:44 2020
3,4,-1,Antihuman,[新聞] 顧客拿「餐廳湯匙」餵狗 網一看全吐了：,Sat Nov 21 11:23:48 2020
1,1,0,awsq00000 (唧唧),[問卦] 遊行不想被誤會 舉反中天會先內戰嗎？,Sat Nov 21 11:05:55 2020
4,2,2,panbanana (香蕉猴子),[問卦] 桃園跟中和要住哪?,Sat Nov 21 00:48:16 2020
17,9,8,GennXu (GennXu),[爆卦] Re,Sat Nov 21 02:25:15 2020
15,3,12,joe19990815 (國中生之眼),[問卦] 考警專要準備幾年?,Sat Nov 21 01:54:11 2020
1,1,0,Ericz7000 (♥艾姬多娜正統老公♥),[問卦] 震驚！鯊鯊都吃什麼？,Sat Nov 21 11:43:43 2020
3,3,0,gotopark (無限風光在險峰),[問卦] 有沒有國考重考換單位的八卦?,Sat Nov 21 10:08:09 2020
4,1,3,a5120358 (月櫻),[問卦] 7-11的現翠茶是不是很難喝阿？,Sat Nov 21 09:55:58 2020
7,2,5,teeo (teeo),[問卦] 歷史上草莽叛軍被招安例子多嗎,Sat Nov 21 09:10:26 2020
2,2,0,chamge7788 (經濟王7887),[問卦] 為何trapa 95%黑巧克力很便宜,Sat Nov 21 07:54:00 2020
16,9,7,lpbrother (LP哥(LP = Love & Peace)),[新聞] 接送未滿7歲童上下車 12月起臨停無3分鐘,Sat Nov 21 07:26:54 2020
6,1,5,XDDDDDDDDDD (我笑他人看不穿),Re,Sat Nov 21 09:46:25 2020
5,4,1,icefish712 (冰魚),[問卦] 醫師跟病人做愛vs法官與被告做愛,Sat Nov 21 10:42:22 2020
3,0,3,lowlow1980 (revenge),Re,Sat Nov 21 02:57:01 2020
2,1,1,gyGirl (妹),Re,Sat Nov 21 08:45:17 2020
4,1,3,silvertime (silvertime),[問卦] 如何跟芭樂解釋為什麼他身上有茄紅素,Sat Nov 21 00:48:55 2020
4,0,4,SteveSmith (史密斯),Re,Sat Nov 21 08:48:05 2020
5,0,5,hwang1460 (面癱P),[爆卦] 伊利諾州又居家隔離了耶,Sat Nov 21 07:21:08 2020
8,1,7,girl55665566 (同志友善ID),[公告] 午餐前der水桶,Sat Nov 21 11:45:41 2020
826,148,678,bsnon (BSNON),[新聞] 調理包遭爆地下工廠製 皇家傳承拒檢市府,Sat Nov 21 00:54:16 2020
8,6,2,L1ON (我是獅子~(ﾉﾟ▽ﾟ)ﾉ♪),[問卦] 為美好的世界獻上祝福？,Sat Nov 21 05:24:30 2020
2,1,1,ncc5566 (政大宅男),[問卦] 熱三小?,Sat Nov 21 10:23:39 2020
9,4,5,ya01234 (姆咪),Re,Sat Nov 21 06:30:37 2020
9,1,8,Behind4 (背後4),[問卦] 檢查沒違法 不代表沒違法,Sat Nov 21 02:39:41 2020
1,2,-1,Lawleit (大員郭奉孝),[問卦] 有沒有丘沁偉提告的八卦？,Sat Nov 21 03:19:10 2020
6,17,-11,iou861007 (中壢金城武),[問卦] 洞六洞洞，部隊起床,Sat Nov 21 05:55:25 2020
566,11,555,rayisgreat (在過往中無盡徘徊),Re,Sat Nov 21 01:32:36 2020
1,0,1,ostracize (bucolic),Re,Sat Nov 21 11:51:19 2020
8,0,8,Fujiwarano (獨孤浪客號：),[問卦] 有沒有yutube公司不管中國假消息影片八卦,Sat Nov 21 09:01:55 2020
9,1,8,Kitakami (公主連結特約工讀生),[新聞] Google地圖加拿大麥田圈驚見巨大懶叫,Sat Nov 21 07:46:22 2020
1,0,1,bob85017 (叭ㄅㄨ),[問卦] 夏多懷特做什麼才能成功,Sat Nov 21 09:36:23 2020
17,2,15,ohlong (強森),[新聞] 陸外交部回嗆五眼聯盟：小心眼睛被戳瞎,Sat Nov 21 11:07:51 2020
31,6,25,lauwei (lauwei),[問卦] 新來的菜排為什麼要跟士官長問好？,Sat Nov 21 10:29:09 2020
8,0,8,a14589761 (下麵超好吃),[問卦] 人為什麼還沒演化成會飛或會潛水？,Sat Nov 21 09:48:09 2020
5,1,4,KikiWi (閃電),[問卦] 全世界的男人進入聖人模式會怎樣？,Sat Nov 21 03:04:43 2020
2,2,0,Birthday5566 (生日5566),[問卦] 顏色不對會怎麼樣？,Sat Nov 21 10:50:25 2020
0,0,0,there801021 (老衲),[問卦] 台北那麼塞是不是因為4輪仔阿？,Sat Nov 21 12:04:44 2020
2,2,0,zhwang2123 (123456),[問卦] 穿衝鋒衣能衝多快?,Sat Nov 21 01:48:42 2020
69,6,63,med5566 (美德5566),[問卦] 在Costco看到小孩哭了一個小時,Sat Nov 21 08:10:58 2020
5,0,5,s66449 (老實樣),[新聞] 電車線有塑膠繩索！台鐵桃園-內壢站,Sat Nov 21 10:39:52 2020
46,5,41,benson8389 (怕美魯克拉魯克),[問卦]家裡窗台有鳥來築巢下蛋怎麼辦?,Sat Nov 21 10:01:21 2020
4,6,-2,smallpig02 (小豬二號),Re,Sat Nov 21 03:31:58 2020
2,7,-5,notmine (just melancholy),[問卦] 可不可以請自助洗車場不要再放鄧紫棋的歌,Sat Nov 21 11:45:46 2020
4,0,4,JessVeron (LisaMarine),Re,Sat Nov 21 09:09:10 2020
0,0,0,LIN9 (LIN9),[新聞] 昔護陳幸妤的南港女里長過世 陳水扁專程,Sat Nov 21 12:01:54 2020
5,2,3,ben28 (ben),[問卦] 牛津疫苗你敢打嗎？,Sat Nov 21 09:22:21 2020
7,3,4,zxc881230 (神槍手打手槍神),[問卦] 異形系列在紅什麼,Sat Nov 21 01:05:15 2020
5,4,1,"Firstshadow (凱留醬><"")",[問卦] 欸！這時間是不是沒東西能吃,Sat Nov 21 06:20:55 2020
28,3,25,kcbill (明日やろうは馬鹿野郎だ),[爆卦] 川普大兒子確診,Sat Nov 21 07:12:26 2020
5,13,-8,ccf52881 (ccf52881),[新聞] 陳菊：蘇貞昌承擔責任辛苦 沒有換閣揆問,Sat Nov 21 11:42:35 2020
15,3,12,s080014 (wei),[問卦] 為何越南洗頭店，台北沒有,Sat Nov 21 09:56:26 2020
1,1,0,Hertzfeld (Google+),[問卦] 駕照考試的筆試導入申論與倒扣，可以阻,Sat Nov 21 11:11:23 2020
31,0,31,jiba50331 (Kerker),[協尋] 代po 汐止區康寧街靠明峰街交通事故,Mon Nov 16 16:37:57 2020
7,5,2,bear26 (熊二六),[問卦] 有沒有父權其實是女人建立的卦？,Sat Nov 21 04:29:56 2020
3,2,1,Marle (大眼虎斑貓),[問卦] 有沒有交友軟體一堆教練的八卦？,Sat Nov 21 01:31:24 2020
27,2,25,rote (ROTE),[問卦] 是誰舉報皇家傳承的會不會被表揚的卦?!,Sat Nov 21 09:14:55 2020
5,6,-1,seabox (盒盒),[問卦] 震撼彈！檢舉王要辭八卦板主,Sat Nov 21 09:34:37 2020
10,11,-1,kivan00 (Kivan),[新聞] 習近平搶進CPTPP 王美花：這對中國相關門,Sat Nov 21 11:35:15 2020
9,3,6,bengowa (鞭狗蛙 舒服),[問卦] 憂鬱症484其實是物競天擇的一環？,Sat Nov 21 09:16:42 2020
0,0,0,ruthertw (督人無數就是我),"[問卦] 動漫史上哪些橋段感動到哽咽,說不出話來?",Sat Nov 21 12:01:56 2020
11,14,-3,gn1384181 (gn1384181),[問卦] 香港覺青被老共抓去關以後怎麼乖成這樣?,Sat Nov 21 09:26:25 2020
0,0,0,todao (心裡有數),[問卦] 一個人最多可參加幾個團？,Sat Nov 21 11:59:45 2020
7,0,7,kille898983 (killer),[問卦]  有沒有如何制裁檢舉達人的八卦,Sat Nov 21 01:33:17 2020
4,3,1,TalkToMe (跟我說一下啦),Re,Sat Nov 21 04:46:33 2020
6,0,6,ak904 (AK),[新聞] 男性「大小」與收入有關？英研究讓台鄉民,Sat Nov 21 10:04:40 2020
9,0,9,suweiQQ (寶貝),[問卦] 光泉豆漿集點是不是在整人,Sat Nov 21 09:43:17 2020
6,2,4,ptt987654321 (),Re,Sat Nov 21 11:35:50 2020
5,0,5,ivorysoap (ivorysoap),[問卦] 皇家傳承會讓各位想到什麼?,Sat Nov 21 10:56:50 2020
3,2,1,Mesenne (姆咪姆咪),[問卦] 肥宅睡13小時還想睡該怎麼辦？,Sat Nov 21 11:03:53 2020
3,0,3,be00148 (有新信件還沒看),[問卦] 基改食品可以標萊豬不能標,Sat Nov 21 01:22:40 2020
56,19,37,ich2 (北川石原都是我老婆),[問卦] 台北市以外怎麼沒有待轉大富翁？,Sat Nov 21 09:26:25 2020
8,2,6,heykate (捏雞雞自殺),[問卦] Momo的奶子大概多大?,Sat Nov 21 09:28:24 2020
78,6,72,louischaaoo (老人一枚),[問卦] 當兵的飲食真的很恐怖嗎？,Sat Nov 21 08:47:21 2020
2,3,-1,b08297 (),[問卦] 所以食安到底重不重要,Sat Nov 21 10:25:17 2020
0,0,0,blueskymaple (你是不是在發球),[問卦] 台北肉圓都紅紅的還沒有白醬,Sat Nov 21 12:02:27 2020
6,0,6,gd2s0203 (我愛大發),[協尋] 高雄忠烈祠失物招領,Sat Nov 21 03:21:33 2020
17,1,16,xiikjuy (xiikjuy),[問卦] 小時候運動會印象最深的是甚麼,Sat Nov 21 03:17:39 2020
0,0,0,douglasjs (帥到吐),Re,Sat Nov 21 12:02:51 2020
9,2,7,stratege (我愛風目魚),[問卦] 你敢動我的馬 我就幹你的狗,Sat Nov 21 11:28:46 2020
3,0,3,llgod (Wryyyyyyyy),[問卦] 認真問，這種胡椒鹽哪裡買?,Sat Nov 21 11:17:22 2020
1,4,-3,wwf1310 (大賺3千小賠5萬),[問卦] 食人魔漢尼拔的八卦？,Sat Nov 21 01:11:39 2020
2,0,2,sodistrues (true),Re,Sat Nov 21 11:51:33 2020
8,5,3,james7923 (詹姆士Q),[新聞] 逾百騎士路口待轉 北市警勸導,Sat Nov 21 11:34:06 2020
4,3,1,johanLarson (Rent),[問卦] 有沒有4%糾察隊？,Sat Nov 21 11:14:15 2020
2,0,2,skizard ( ),Re,Sat Nov 21 10:31:02 2020
2,1,1,Ensidia (要宅的這麼神是有難度的),Re,Sat Nov 21 00:48:48 2020
9,0,9,CuLiZn5566 (同理心5566),Re,Sat Nov 21 08:32:12 2020
3,0,3,sdamel (=ˇ=),[問卦] 汁波蜜奮鬥記,Sat Nov 21 09:50:10 2020
5,1,4,YumingHuang (連鎖效應),[新聞] 停灌後遺症》糧價探底！停灌區次級米連,Sat Nov 21 08:54:09 2020
4,0,4,ostracize (bucolic),Re,Sat Nov 21 09:18:18 2020
1,0,1,gyGirl (妹),Re,Sat Nov 21 09:02:53 2020
5,0,5,ltytw (拉米亞妹妹),[問卦] 口感肥肥耶耶爛爛的4紅燒鰻還是烤鰻?,Sat Nov 21 04:00:02 2020
0,0,0,ikoy (？？？？),[問卦] 手搖店飲料加冰塊有沒有調味,Sat Nov 21 11:11:41 2020
6,2,4,maybetodo (np),[問卦] 待轉大富翁的車子是不是很少？,Sat Nov 21 10:33:43 2020
3,4,-1,dreamgirl (小糯米),[問卦] 秋冬專案是否違憲,Sat Nov 21 10:04:20 2020
34,4,30,aure0914 (tunik),[問卦] 上聯：「歐拉歐拉歐拉歐拉」，下聯？,Sat Nov 21 10:08:50 2020
11,0,11,leondemon (狗狗),Re,Sat Nov 21 02:41:07 2020
6,1,5,kinki999 (QQk 廢文被劣文中),[問卦] 夜叉姬虐殺一堆貓是不是很舒服,Sat Nov 21 00:43:55 2020
2,0,2,Lorazin (Lorazin),Re,Sat Nov 21 10:51:03 2020
11,5,6,WaWa3 (寂寞的麻糬),[問卦] 和高學歷乖巧台女做愛4什麼感覺？,Sat Nov 21 03:44:17 2020
7,0,7,kellyMa (kelly),[問卦] 小七的送貨員到底多疲憊,Sat Nov 21 03:58:17 2020
8,0,8,slovea (YiYinKing),[問卦] 自由平等是不是矛盾的存在,Sat Nov 21 11:35:22 2020
13,4,9,purue (purue),[問卦] 奸臣才華一定比較差嗎,Sat Nov 21 07:21:58 2020
4,4,0,end56 (終結56),Re,Sat Nov 21 10:35:39 2020
2,4,-2,llgod (Wryyyyyyyy),[問卦] 什麼台、站關了你會生氣氣,Sat Nov 21 10:24:59 2020
4,0,4,naligono (那尼),[問卦] 吃了綜合維他命狂放屁怎麼辦,Sat Nov 21 10:14:50 2020
10,1,9,sunbysea (忠言逆耳良藥苦口),[新聞] Dominion臨陣缺席賓州眾院聽證會 左媒視而,Sat Nov 21 09:48:27 2020
10,2,8,q5212 (q5212),[問卦] 分享小蘇打倒入水管、馬桶、洗衣機心態???,Sat Nov 21 01:47:43 2020
7,3,4,Emerson158 (紅豆 X 八嘎 X 烏魯賽),"[問卦] 寧願住台北市但通勤桃竹,是什麼考量呢?",Sat Nov 21 01:12:38 2020
6,1,5,BIA (必亞),[問卦] 為啥農地工廠合法 皇家工廠非法？,Sat Nov 21 10:23:36 2020
1,0,1,Gazooli (窩4肥宅),[問卦] pornhub一定要看的,Sat Nov 21 12:04:23 2020
5,2,3,lllll12b56 (張航嘉),[問卦] 為什麼周杰倫的歌不會聽起來很芭樂?,Sat Nov 21 08:42:49 2020
58,10,48,AisinGioro (愛新覺羅。溥聰),[問卦] 為什麼反萊豬要跟反關台遊行綁在一起,Sat Nov 21 10:28:16 2020
3,1,2,teeheehee (軟尾拋拋翔(′・ω・`)),[問卦] 用調理包做菜 會被Gordon Ramsay罵嗎？,Sat Nov 21 11:05:53 2020
53,3,50,STAV72 (刁民黨黨務主委),[新聞] 普丁爆「罹癌＋帕金森氏症」急動手術　1,Sat Nov 21 11:12:31 2020
63,19,44,cheinshin (那就這樣吧),[新聞] 皇家傳承牛肉麵工廠被質疑未登記 侯友宜,Sat Nov 21 11:14:39 2020
2,5,-3,benothing (禹楓),Re,Sat Nov 21 00:48:25 2020
7,1,6,tracymate (混),[新聞] 福義軒胚芽餅出包！標榜無乳化劑涉標示,Sat Nov 21 11:19:47 2020
3,0,3,zyc5566 (和風蒜頭雞湯),Re,Sat Nov 21 04:47:53 2020
2,1,1,liquidbox (樹枝擺擺),Re,Sat Nov 21 11:56:29 2020
5,0,5,biglarge (大大),Re,Sat Nov 21 10:43:12 2020
5,0,5,del680202 (HANA),[問卦] 丁姓宗親是大宗嗎,Sat Nov 21 08:00:27 2020
20,10,10,chun0303 (chun),[新聞] 好消息　武肺疫苗買到了  ,Sat Nov 21 09:12:54 2020
8,1,7,Derekao (Derek),[問卦] 六隻上弦+無慘 搬到現代可以演幾集,Sat Nov 21 11:09:32 2020
9,2,7,morris1661 (morris),[問卦] 現在國中生都流行甚麼阿?????,Sat Nov 21 10:47:39 2020
5,0,5,w510048 (黨的恩情比山高),[新聞] 潛艦國造原型艦敲定24日開工典禮 邀請函,Sat Nov 21 01:25:25 2020
1,0,1,ccyaztfe (best_troll_tw),Re,Sat Nov 21 11:18:03 2020
95,22,73,aaaba (小強),[新聞] 「皇家傳承」調理包工廠疑未登記 新北經,Sat Nov 21 09:53:56 2020
1,4,-3,y3226999 (咪苦說她喜歡我 >///<),[問卦] 肥宅甩門有加分嗎==？,Sat Nov 21 04:06:47 2020
44,8,36,Coffeewater (淡淡的咖啡),[新聞] 逃出中國最大半導體騙局 蔣尚義：我在武漢弘芯的經歷根本是,Sat Nov 21 07:44:48 2020
11,0,11,leon105 (@@),[新聞] 台中男搶付帳變大鬧KTV打服務員　囂張嗆,Sat Nov 21 11:36:52 2020
39,5,34,olmtw (olmtw),[新聞] 台鐵司機猛男桌曆 利用跑車空檔狂健身,Sat Nov 21 09:03:44 2020
12,4,8,livi362 (四趴仔),[新聞] 反萊豬挺中天 桃園串聯上凱道,Sat Nov 21 10:32:02 2020
1,1,0,anecam (人生イージーモード),Re,Sat Nov 21 08:40:17 2020
10,1,9,ggyunyun (斑馬斑馬),[問卦] 在洛克希德馬丁上班是甚麼感覺Lockheed M,Sat Nov 21 07:41:54 2020
5,1,4,lelena (馬利克),[問卦] 大洪水的八卦?,Sat Nov 21 09:39:53 2020
7,1,6,NANACE (薰王),[問卦] 查水錶根本都市傳說吧？,Sat Nov 21 08:22:01 2020
2,0,2,JHGF2468A (Joker),[問卦] beptt不會自動開圖,Sat Nov 21 08:19:51 2020
2,2,0,doro0202 (Doro),Re,Sat Nov 21 03:10:40 2020
10,6,4,became (windim),[問卦] 若被嗆別人都違法為什麼只抓我！怎回呢,Sat Nov 21 11:11:05 2020
3,12,-9,qwe00489 (哭哭喔),[問卦] 早起的肥宅在幹嘛,Sat Nov 21 06:34:26 2020
28,4,24,lpbrother (LP哥(LP = Love & Peace)),Re,Sat Nov 21 09:20:16 2020
7,0,7,nyu5765 (nyu5765),[問卦] 有線電視在經濟學上算是寡占事業嗎??,Sat Nov 21 08:30:31 2020
2,0,2,jimlexus (小山丘),Re,Sat Nov 21 05:49:43 2020
1,0,1,LewisRong (陳金鋒世代),Re,Sat Nov 21 01:00:55 2020
2,1,1,mktgoago990 (就愛冷泡茶),Re,Sat Nov 21 02:50:17 2020
8,4,4,cook840787 (恩好掰掰),[問卦] 你各位用哪個APP看PTT啊,Sat Nov 21 06:43:34 2020
2,0,2,minche (),[問卦] 開賣營養午餐的餐廳會不會賺錢,Sat Nov 21 02:15:26 2020
18,3,15,billchen183 (比爾陳183),[新聞] Angelababy「被整形女網紅嚇到」 當場傻,Sat Nov 21 03:58:28 2020
5,0,5,flower42 (栗悟飯與龜波功),[問卦] 同事把洗手乳加水稀釋的八卦?,Sat Nov 21 11:01:26 2020
4,2,2,VortexSheet (哦?),"[問卦] Sony is guilty, he makes our people an",Sat Nov 21 09:12:36 2020
11,1,10,sodistrues (true),[問卦]獵人小傑爸爸沒變大金的話 有比會長強？,Sat Nov 21 09:00:27 2020
34,2,32,Usayhiisayha (【〖《〔（{`}）〕》〗】),[問卦] 當兵為何要頭尾交叉睡？,Sat Nov 21 10:14:37 2020
4,0,4,dean1990 (狄恩院長),[問卦] 麥當勞攻進調理包市場，有搞頭嗎？,Sat Nov 21 11:06:42 2020
